11,11,11,11,11,11,11,11,11,11
11,6,11,5,5,5,5,11,0,11
11,9,11,5,5,5,5,11,3,11
11,8,11,5,5,5,5,11,2,11
11,10,11,5,5,5,5,11,4,11
11,11,11,11,11,11,11,11,11,11
